111111111111111
10000000E000101
100100000000101
100100000C00001
100100011111111
10011C11C000001
100111111111001
100000000000001
100P11111100001
111111111111111
