1111111
1P1C001
1010101
10001E1
11111111
