11111
1E121
10011
1CP01
11111
