1111111111
1C100000E1
11C00000P1
1010000001
1111111111
