1111111
1000P01
1E00001
1000C10
1111111
